15,16,16,16,16,16,16,16,16,16,16,16,16,16,16,16,16,16,16,16,16,16,16,16,16,16,16,16,16,16,16,16,16,16,16,16,16,16,16,16,16,16,16,16,16,16,16,16,16,16,16,16,16,16,16,16,16,16,16,17,
18,19,19,19,19,19,19,19,19,19,19,19,19,19,19,19,19,19,19,19,19,19,19,19,1,2,3,3,3,3,3,3,4,19,19,19,19,19,19,19,19,19,19,19,19,19,19,19,19,19,19,19,19,19,19,19,19,19,19,20,
18,19,19,19,32,33,19,19,32,33,32,33,19,32,33,19,32,33,19,19,19,19,19,1,1,5,6,6,6,6,6,6,7,1,1,32,33,19,1,19,2,3,3,3,3,3,3,4,19,19,19,19,1,1,19,32,33,19,19,20,
18,19,32,33,34,35,19,19,34,35,34,35,19,34,35,19,34,35,19,19,19,19,1,1,1,5,6,6,6,6,6,6,7,1,1,34,35,19,1,19,5,6,6,6,6,6,6,7,1,32,33,1,1,1,1,34,35,19,19,20,
18,19,34,35,36,37,19,19,36,37,36,37,19,36,37,19,36,37,19,19,19,19,1,1,1,5,6,6,6,6,6,6,7,1,19,36,37,1,1,19,5,6,6,6,6,6,6,7,1,34,35,19,32,33,1,36,37,19,19,20,
18,19,36,37,19,19,19,19,19,19,19,19,19,19,19,19,19,19,19,19,19,19,1,1,1,5,6,6,6,6,6,6,7,1,1,1,1,1,1,1,5,6,6,6,6,6,6,7,1,36,37,19,34,35,1,1,1,1,19,20,
18,19,19,19,19,19,19,19,19,19,19,2,3,3,3,3,3,3,4,19,32,33,1,1,1,5,6,6,6,6,6,6,7,1,1,1,1,1,1,1,5,6,6,6,6,6,6,7,1,1,1,1,36,37,1,1,1,1,19,20,
18,19,19,19,32,33,19,32,33,19,19,5,6,6,6,6,6,6,7,19,34,35,1,1,1,5,6,6,6,6,6,6,7,19,1,1,1,19,1,19,5,6,6,6,6,6,6,7,1,1,32,33,19,19,19,19,32,33,19,20,
18,19,19,19,34,35,19,34,35,19,19,5,6,6,6,6,6,6,7,19,36,37,1,1,1,8,9,9,9,9,9,9,10,19,1,1,1,1,1,19,5,6,6,6,6,6,6,7,1,1,34,35,1,1,1,19,34,35,19,20,
18,19,19,19,36,37,19,36,37,19,19,5,6,6,6,6,6,6,7,19,19,19,1,1,1,11,12,12,12,12,12,12,13,19,19,1,1,32,33,19,8,9,9,9,9,9,9,10,19,19,36,37,1,1,1,1,36,37,19,20,
18,19,19,19,19,19,19,19,19,19,19,5,6,6,6,6,6,6,7,19,1,1,1,1,1,19,19,19,19,19,19,19,1,32,33,1,1,34,35,19,11,12,12,12,12,12,12,13,19,19,19,19,19,1,1,1,1,1,1,20,
18,19,19,19,19,19,19,19,32,33,19,5,6,6,6,6,6,6,7,19,1,1,1,1,1,19,19,32,33,19,1,1,19,34,35,19,19,36,37,1,1,19,19,19,14,1,1,14,19,19,2,3,3,3,3,3,3,4,19,20,
18,19,32,33,19,32,33,19,34,35,19,5,6,6,6,6,6,6,7,19,19,32,33,19,32,33,19,34,35,19,1,1,14,36,37,19,14,19,19,1,1,14,19,19,19,1,1,19,14,19,5,6,6,6,6,6,6,7,19,20,
18,19,34,35,19,34,35,19,36,37,19,8,9,9,9,9,9,9,10,19,19,34,35,19,34,35,19,36,37,1,26,22,22,22,22,22,22,22,22,22,22,22,22,22,22,22,22,22,22,24,5,6,6,6,6,6,6,7,19,20,
18,19,36,37,19,36,37,19,19,19,19,11,12,12,12,12,12,12,13,19,19,36,37,19,36,37,19,19,19,14,20,28,28,28,28,28,28,28,28,28,28,28,28,28,28,28,28,28,28,18,5,6,6,6,6,6,6,7,19,20,
18,19,19,19,19,19,19,19,19,19,19,19,19,19,19,32,33,19,19,19,19,19,19,19,19,19,19,19,14,19,20,28,28,28,28,28,28,28,28,28,28,28,28,28,28,28,28,28,28,18,5,6,6,6,6,6,6,7,19,20,
18,19,2,3,3,3,3,3,3,4,19,32,33,19,19,34,35,19,19,19,19,2,3,3,3,3,3,3,4,19,20,28,28,28,28,28,28,28,28,28,28,28,28,28,28,28,28,28,28,18,5,6,6,6,6,6,6,7,19,20,
18,19,5,6,6,6,6,6,6,7,19,34,35,19,19,36,37,19,19,19,19,5,6,6,6,6,6,6,7,19,20,28,28,28,28,28,28,28,28,28,28,28,28,28,28,28,28,28,28,18,5,6,6,6,6,6,6,7,19,20,
18,19,5,6,6,6,6,6,6,7,19,36,37,19,19,19,19,19,32,33,19,5,6,6,6,6,6,6,7,19,20,28,28,28,28,28,28,28,28,28,28,28,28,28,28,28,28,28,28,18,8,9,9,9,9,9,9,10,19,20,
18,19,5,6,6,6,6,6,6,7,19,1,19,19,32,33,1,1,34,35,19,5,6,6,6,6,6,6,7,19,20,28,28,28,28,28,28,28,28,28,28,28,28,28,28,28,28,28,28,18,11,12,12,12,12,12,12,13,19,20,
18,19,5,6,6,6,6,6,6,7,19,1,1,1,34,35,1,1,36,37,19,5,6,6,6,6,6,6,7,19,20,28,28,28,28,28,28,15,16,16,16,16,17,28,28,28,28,28,28,18,19,19,32,33,32,33,19,19,19,20,
18,19,5,6,6,6,6,6,6,7,19,1,1,1,36,37,19,1,1,19,1,5,6,6,6,6,6,6,7,19,20,28,28,28,28,28,28,18,19,19,19,14,20,28,28,28,28,28,28,18,19,19,34,35,34,35,19,19,19,20,
18,19,5,6,6,6,6,6,6,7,1,1,32,33,19,19,32,33,1,1,1,5,6,6,6,6,6,6,7,19,20,28,28,28,28,28,28,18,19,14,19,19,20,28,28,28,28,28,28,18,31,14,36,37,36,37,14,14,19,20,
18,19,8,9,9,9,9,9,9,10,1,1,34,35,19,19,34,35,19,1,1,8,9,9,9,9,9,9,10,19,20,28,28,28,28,28,28,18,32,33,19,19,20,28,28,28,28,28,28,21,22,22,22,22,22,22,22,22,22,23,
18,19,11,12,12,12,12,12,12,13,19,19,36,37,1,1,36,37,19,1,1,11,12,12,12,12,12,12,13,19,20,28,28,28,28,28,28,18,34,35,19,14,20,28,28,28,28,28,28,28,29,29,29,29,29,29,29,29,29,29,
18,19,14,19,19,14,19,14,14,19,31,19,19,19,1,1,19,19,19,19,1,1,1,1,19,19,19,19,19,19,20,28,28,28,28,28,28,18,36,37,19,19,20,28,28,28,28,28,28,28,29,29,29,29,29,29,29,29,29,29,
21,22,22,22,22,22,22,22,22,22,22,22,22,22,22,22,22,22,22,22,22,22,22,24,1,19,19,32,33,19,20,28,28,28,28,28,28,18,19,19,32,33,20,28,28,28,28,28,28,28,29,29,29,29,29,29,29,29,29,29,
29,29,29,29,29,29,29,29,29,29,28,28,28,28,28,28,28,28,28,28,28,28,28,18,1,19,19,34,35,19,20,28,28,28,28,28,28,18,14,19,34,35,20,28,28,28,28,28,28,28,29,29,29,29,29,29,29,29,29,29,
29,29,29,29,29,29,29,29,29,29,28,28,28,28,28,28,28,28,28,28,28,28,28,18,1,32,33,36,37,19,20,28,28,28,28,28,28,18,19,19,36,37,20,28,28,28,28,28,28,28,29,29,29,29,29,29,29,29,29,29,
29,29,29,29,29,29,29,29,29,29,28,28,28,28,28,28,28,28,28,28,28,28,28,18,1,34,35,19,1,1,20,28,28,28,28,28,28,18,19,32,33,19,27,16,16,16,16,16,16,16,16,16,16,16,16,16,16,16,16,17,
29,29,29,29,29,29,29,29,29,29,28,28,28,28,28,28,28,28,28,28,28,28,28,18,1,36,37,19,1,19,20,28,28,28,28,28,28,18,19,34,35,19,19,19,19,19,19,19,19,19,14,19,19,14,19,19,14,14,19,20,
29,29,29,29,29,29,29,29,29,29,28,28,28,28,28,28,28,28,28,28,28,28,28,18,1,1,19,1,1,19,20,28,28,28,28,28,28,18,19,36,37,19,19,14,19,14,14,32,33,14,2,3,3,3,3,3,3,4,19,20,
15,16,16,16,16,16,16,16,16,16,16,16,16,16,16,16,16,17,28,28,28,28,28,18,19,1,1,32,33,19,20,28,28,28,28,28,28,18,19,19,19,32,33,32,33,19,19,34,35,19,5,6,6,6,6,6,6,7,19,20,
18,32,33,14,14,32,33,19,14,14,19,19,19,19,19,19,19,20,28,28,28,28,28,18,32,33,1,34,35,19,20,28,28,28,28,28,28,18,19,19,19,34,35,34,35,1,19,36,37,19,5,6,6,6,6,6,6,7,19,20,
18,34,35,19,19,34,35,1,2,3,3,3,3,3,3,4,19,20,28,28,28,28,28,18,34,35,1,36,37,19,20,28,28,28,28,28,28,18,14,19,19,36,37,36,37,1,19,19,19,19,5,6,6,6,6,6,6,7,19,20,
18,36,37,1,1,36,37,1,5,6,6,6,6,6,6,7,19,20,28,28,28,28,28,18,36,37,1,1,19,19,20,28,28,28,28,28,28,18,19,32,33,19,19,19,19,1,32,33,19,19,5,6,6,6,6,6,6,7,19,20,
18,1,1,1,1,1,1,1,5,6,6,6,6,6,6,7,14,20,28,28,28,28,28,18,19,32,33,1,1,19,20,28,28,28,28,28,28,18,19,34,35,19,1,1,1,1,34,35,19,19,5,6,6,6,6,6,6,7,19,20,
18,1,1,32,33,1,1,19,5,6,6,6,6,6,6,7,19,20,28,28,28,28,28,18,19,34,35,19,1,1,20,28,28,28,28,28,28,18,19,36,37,1,1,1,1,1,36,37,19,19,5,6,6,6,6,6,6,7,19,20,
18,1,1,34,35,1,1,19,5,6,6,6,6,6,6,7,14,20,28,28,28,28,28,18,19,36,37,1,1,19,20,28,28,28,28,28,28,18,19,19,1,1,1,1,1,19,19,19,19,19,8,9,9,9,9,9,9,10,19,20,
18,1,1,36,37,1,1,1,5,6,6,6,6,6,6,7,19,20,28,28,28,28,28,18,19,1,1,32,33,19,20,28,28,28,28,28,28,18,19,1,2,3,3,3,3,3,3,4,19,19,11,12,12,12,12,12,12,13,19,20,
18,1,1,1,1,1,1,19,5,6,6,6,6,6,6,7,14,20,28,28,28,28,28,18,1,1,19,34,35,19,20,28,28,28,28,28,28,18,1,1,5,6,6,6,6,6,6,7,19,19,19,19,19,19,19,19,19,19,19,20,
18,1,1,1,1,1,1,19,8,9,9,9,9,9,9,10,19,20,28,28,28,28,28,18,19,1,19,36,37,19,20,28,28,28,28,28,28,18,1,1,5,6,6,6,6,6,6,7,19,19,1,1,1,1,1,1,1,1,19,20,
18,19,1,1,19,32,33,1,11,12,12,12,12,12,12,13,19,20,28,28,28,28,28,21,22,22,22,22,22,22,23,28,28,28,28,28,28,18,1,1,5,6,6,6,6,6,6,7,1,1,1,1,32,33,1,32,33,1,19,20,
18,19,1,1,1,34,35,1,1,1,1,1,1,1,1,19,19,20,28,28,28,28,28,28,28,28,28,28,28,28,28,28,28,28,28,28,28,18,1,1,5,6,6,6,6,6,6,7,19,1,1,1,34,35,1,34,35,1,19,20,
18,19,19,19,1,36,37,19,1,1,1,1,32,33,1,1,19,20,28,28,28,28,28,28,28,28,28,28,28,28,28,28,28,28,28,28,28,18,1,1,5,6,6,6,6,6,6,7,19,1,1,1,36,37,1,36,37,1,1,20,
18,19,32,33,1,1,19,19,32,33,1,1,34,35,1,1,19,20,28,28,28,28,28,28,28,28,28,28,28,28,28,28,28,28,28,28,28,18,1,1,5,6,6,6,6,6,6,7,19,1,19,19,1,1,1,1,1,1,1,20,
18,19,34,35,19,1,1,19,34,35,1,1,36,37,1,1,1,20,28,28,28,28,28,28,28,28,28,28,28,28,28,28,28,28,28,28,28,18,1,1,8,9,9,9,9,9,9,10,1,1,32,33,19,32,33,1,1,1,1,20,
18,19,36,37,19,19,1,1,36,37,1,1,1,1,1,1,1,20,28,28,28,28,28,28,28,28,28,28,28,28,28,28,28,28,28,28,28,18,1,1,11,12,12,12,12,12,12,13,1,19,34,35,19,34,35,1,1,1,1,20,
18,19,19,32,33,19,19,1,19,19,1,1,1,1,32,33,1,27,16,16,16,16,16,16,16,16,16,16,16,16,16,16,16,16,16,16,16,25,1,1,1,1,1,1,1,1,1,1,1,1,36,37,19,36,37,19,1,1,1,20,
18,19,19,34,35,19,19,1,1,1,1,1,1,1,34,35,1,1,1,1,1,1,1,1,1,19,19,1,1,1,1,19,32,33,19,1,1,1,1,1,1,1,32,33,1,1,1,1,19,1,1,19,19,19,19,19,19,1,19,20,
18,19,19,36,37,19,32,33,19,19,19,1,1,1,36,37,19,1,1,1,1,1,1,1,32,33,1,1,1,1,1,1,34,35,1,1,1,1,1,1,1,1,34,35,19,19,19,32,33,19,1,1,1,19,32,33,19,1,1,20,
18,32,33,19,32,33,34,35,32,33,19,32,33,19,1,1,1,1,19,32,33,1,1,1,34,35,19,19,32,33,19,19,36,37,19,1,1,1,32,33,1,1,36,37,19,19,19,34,35,19,1,1,1,1,34,35,19,19,19,20,
18,34,35,19,34,35,36,37,34,35,19,34,35,19,1,1,1,1,19,34,35,19,1,19,36,37,1,1,34,35,1,1,1,1,1,1,1,19,34,35,19,19,19,19,19,19,19,36,37,19,1,1,1,19,36,37,19,19,19,20,
18,36,37,19,36,37,19,19,36,37,19,36,37,32,33,19,1,1,19,36,37,19,19,1,19,19,1,19,36,37,19,19,32,33,19,19,1,1,36,37,19,19,32,33,32,33,19,19,32,33,19,1,1,19,19,32,33,19,19,20,
18,19,19,32,33,19,32,33,19,19,19,19,19,34,35,32,33,19,19,19,19,32,33,1,1,1,32,33,1,19,32,33,34,35,19,19,32,33,1,19,32,33,34,35,34,35,19,19,34,35,19,19,32,33,19,34,35,19,19,20,
18,19,19,34,35,19,34,35,19,32,33,19,19,36,37,34,35,32,33,19,19,34,35,1,32,33,34,35,1,1,34,35,36,37,32,33,34,35,1,1,34,35,36,37,36,37,19,19,36,37,19,19,34,35,19,36,37,19,19,20,
18,19,19,36,37,19,36,37,19,34,35,32,33,19,19,36,37,34,35,19,19,36,37,19,34,35,36,37,1,1,36,37,32,33,34,35,36,37,32,33,36,37,32,33,19,19,32,33,19,19,32,33,36,37,32,33,19,32,33,20,
18,19,19,19,19,19,19,19,19,36,37,34,35,19,19,19,19,36,37,19,19,19,19,19,36,37,19,19,19,1,19,19,34,35,36,37,19,19,34,35,19,19,34,35,19,19,34,35,19,19,34,35,19,19,34,35,19,34,35,20,
18,19,19,19,19,19,19,19,19,19,19,36,37,19,19,19,19,19,19,19,19,19,19,19,19,19,19,19,19,19,19,19,36,37,19,19,19,19,36,37,19,19,36,37,19,19,36,37,19,19,36,37,19,19,36,37,19,36,37,20,
21,22,22,22,22,22,22,22,22,22,22,22,22,22,22,22,22,22,22,22,22,22,22,22,22,22,22,22,22,22,22,22,22,22,22,22,22,22,22,22,22,22,22,22,22,22,22,22,22,22,22,22,22,22,22,22,22,22,22,23