1 1 1 1 1 1 1 1 30 31 32 33 26 27 28 29 18 19 20 21 26 27 28 29 18 19 20 21 26 27 28 29 18 19 20 21 26 27 28 29 18 19 20 21 26 27 28 29 30 31 32 33 1 1 1 1 1 1 1 1 
1 1 1 1 1 1 34 35 36 37 1 1 30 31 32 33 22 23 24 25 30 31 32 33 22 23 24 25 30 31 32 33 22 23 24 25 30 31 32 33 22 23 24 25 30 31 32 33 37 1 1 1 1 1 1 1 1 1 1 1 
1 1 1 1 1 1 38 39 1 41 1 1 1 1 1 1 26 27 28 29 18 19 20 21 26 27 28 29 18 19 20 21 26 27 28 29 18 19 20 21 26 27 28 29 1 38 39 1 41 1 1 1 1 1 1 1 1 1 1 1 
1 1 1 1 1 1 42 1 1 45 1 1 1 1 1 1 30 31 32 33 22 23 24 25 30 31 32 33 22 23 24 25 30 31 32 33 22 23 24 25 30 31 32 33 1 42 1 1 45 1 1 34 35 36 37 1 1 1 1 1 
1 1 1 1 1 1 46 47 48 49 1 34 35 36 37 1 1 1 1 1 26 27 28 29 18 19 20 21 26 27 28 29 18 19 20 21 26 27 28 29 1 1 1 1 1 46 47 48 49 1 1 38 39 1 41 1 1 1 1 1 
1 1 34 35 36 37 1 1 1 1 1 38 39 1 41 1 1 1 1 1 30 31 32 33 22 23 24 25 30 31 32 33 22 23 24 25 30 31 32 33 1 1 1 1 1 1 1 1 1 1 1 42 1 1 45 1 1 1 1 1 
1 1 38 39 1 41 1 1 1 1 1 42 1 1 45 1 1 1 1 1 1 1 1 1 26 27 28 29 18 19 20 21 26 27 28 29 30 31 32 33 1 1 1 1 1 1 1 1 1 1 1 46 47 48 49 1 1 1 1 1 
1 1 42 1 1 45 1 1 1 1 1 46 47 48 49 1 1 1 1 1 1 1 1 1 30 31 32 33 22 23 24 25 30 31 32 33 1 1 1 1 1 1 1 1 34 35 36 37 1 1 1 1 1 1 1 1 1 1 1 1 
1 1 46 47 48 49 1 1 1 1 1 1 1 1 1 1 1 1 1 1 1 1 1 1 1 1 1 1 26 27 28 29 1 1 1 1 1 1 1 1 1 1 1 1 38 39 1 41 1 1 1 1 1 1 1 1 1 1 1 1 
1 1 1 1 1 1 34 35 36 37 1 1 1 1 1 34 35 36 37 1 1 1 1 1 1 1 1 1 30 31 32 33 1 1 1 1 1 1 1 1 1 1 1 1 42 1 1 45 1 1 1 34 35 36 37 1 1 1 1 1 
1 1 1 1 1 1 38 39 1 41 1 1 1 1 1 38 39 1 41 1 1 1 1 1 34 35 36 37 1 50 1 1 34 35 36 37 1 1 1 1 1 1 1 1 46 47 48 49 1 1 1 38 39 1 41 1 1 1 1 1 
1 1 1 1 1 1 42 1 1 45 1 1 1 1 1 42 1 1 45 1 1 1 1 1 38 39 1 41 2 3 4 5 38 39 1 41 1 1 1 1 34 35 36 37 1 1 1 1 1 1 1 42 1 1 45 1 1 1 1 1 
1 1 1 1 1 1 46 47 48 49 1 1 1 1 1 46 47 48 49 1 1 1 1 1 42 1 1 45 6 7 8 9 42 1 1 45 1 1 1 1 38 39 1 41 1 1 1 1 1 1 1 46 47 48 49 1 1 1 1 1 
1 1 1 1 1 1 1 1 1 1 1 1 1 1 1 1 1 1 1 1 1 1 1 1 46 47 48 49 6 7 8 9 46 47 48 49 1 1 1 1 42 1 1 45 1 1 1 1 1 1 1 1 1 1 1 1 1 1 1 1 
1 1 1 34 35 36 37 1 1 1 18 19 20 21 18 19 20 21 1 1 34 35 36 37 1 1 1 1 6 7 8 9 1 1 1 1 34 35 36 37 46 47 48 49 1 1 1 1 1 1 1 1 1 1 1 1 1 1 1 1 
1 1 1 38 39 1 41 1 1 1 22 23 24 25 22 23 24 25 1 1 38 39 1 41 1 1 1 1 6 7 8 9 1 1 1 1 38 39 1 41 18 19 20 21 18 19 20 21 1 1 1 1 1 34 35 36 37 1 1 1 
1 1 1 42 1 1 45 1 1 1 26 27 28 29 26 27 28 29 1 1 42 1 1 45 1 1 1 1 6 7 8 9 1 1 1 1 42 1 1 45 22 23 24 25 22 23 24 25 1 1 1 1 1 38 39 1 41 1 1 1 
1 1 1 46 47 48 49 1 1 1 30 31 32 33 30 31 32 33 1 1 46 47 48 49 1 1 1 1 6 7 8 9 1 1 1 1 46 47 48 49 26 27 28 29 26 27 28 29 1 1 1 1 1 42 1 1 45 1 1 1 
1 1 1 1 1 1 1 1 1 1 18 19 20 21 18 19 20 21 34 35 36 37 1 1 18 19 20 21 6 7 8 9 1 1 34 35 36 37 1 1 30 31 32 33 30 31 32 33 1 1 1 1 1 46 47 48 49 1 1 1 
1 1 1 1 1 1 34 35 36 37 22 23 24 25 22 23 24 25 38 39 1 41 1 1 22 23 24 25 6 7 8 9 1 1 38 39 1 41 1 1 18 19 20 21 18 19 20 21 1 1 1 1 1 1 1 1 1 1 1 1 
1 1 1 1 1 1 38 39 1 41 26 27 28 29 26 27 28 29 42 1 1 45 1 1 26 27 28 29 6 7 8 9 1 1 42 1 1 45 1 1 22 23 24 25 22 23 24 25 1 1 1 1 1 1 1 1 1 1 1 1 
1 1 1 1 1 1 42 1 1 45 30 31 32 33 30 31 32 33 46 47 48 49 1 1 30 31 32 33 6 7 8 9 1 1 46 47 48 49 1 1 26 27 28 29 26 27 28 29 1 1 1 1 1 1 1 1 1 1 1 1 
1 1 1 1 1 1 46 47 48 49 1 1 1 1 1 1 1 1 1 34 35 36 37 1 1 1 1 1 6 7 8 9 1 1 1 34 35 36 37 1 30 31 32 33 30 31 32 33 1 1 1 1 1 1 1 1 1 1 1 1 
1 1 1 1 1 1 1 1 34 35 36 37 1 1 1 34 35 36 37 38 39 1 41 1 1 1 1 1 6 7 8 9 1 1 1 38 39 1 41 1 1 1 1 1 1 1 1 1 1 1 1 1 1 34 35 36 37 1 1 1 
1 1 1 1 1 1 1 1 38 39 1 41 1 1 1 38 39 1 41 42 1 1 45 1 1 1 1 1 6 7 8 9 1 1 1 42 1 1 45 1 1 1 1 1 1 1 1 1 1 1 1 1 1 38 39 1 41 1 1 1 
1 1 1 1 1 1 1 1 42 1 1 45 1 1 1 42 1 1 45 46 47 48 49 1 1 1 1 1 6 7 8 9 1 1 1 46 47 48 49 1 1 1 1 1 1 1 1 1 1 1 1 1 1 42 1 1 45 1 1 1 
1 1 1 1 1 1 1 1 46 47 48 49 1 1 1 46 47 48 49 1 34 35 36 37 1 1 1 1 6 7 8 9 18 19 20 21 1 1 34 35 36 37 1 1 1 1 1 1 1 1 1 1 1 46 47 48 49 1 1 1 
1 1 1 1 1 1 1 1 1 1 1 1 34 35 36 37 1 1 1 1 38 39 1 41 1 1 1 1 6 7 8 9 22 23 24 25 1 1 38 39 1 41 1 1 1 1 1 1 1 1 1 1 1 1 1 1 1 1 1 1 
1 1 1 1 1 1 34 35 36 37 1 1 38 39 1 41 1 1 1 1 42 1 1 45 1 1 1 1 6 7 8 9 26 27 28 29 1 1 42 1 1 45 1 1 1 1 18 19 20 21 18 19 20 21 1 1 1 1 1 1 
1 1 1 1 1 1 38 39 1 41 1 1 42 1 1 45 1 1 1 1 46 47 48 49 1 1 1 1 6 7 8 9 30 31 32 33 1 1 46 47 48 49 1 1 1 1 22 23 24 25 22 23 24 25 1 1 1 1 1 1 
1 1 1 1 1 1 42 1 1 45 1 1 46 47 48 49 34 35 36 37 1 1 1 1 18 19 20 21 10 11 12 13 1 1 1 1 34 35 36 37 1 1 1 1 1 1 26 27 28 29 26 27 28 29 1 1 1 1 1 1 
1 1 1 1 1 1 46 47 48 49 1 1 1 1 1 1 38 39 1 41 1 1 1 1 22 23 24 25 10 11 12 13 1 1 1 1 38 39 1 41 1 1 1 1 1 1 30 31 32 33 30 31 32 33 1 1 1 1 1 1 
1 1 34 35 36 37 1 1 1 1 1 1 1 1 1 1 42 1 1 45 1 1 1 1 26 27 28 29 10 11 12 13 1 1 1 1 42 1 1 45 1 1 1 1 1 1 18 19 20 21 18 19 20 21 1 1 1 1 1 1 
1 1 38 39 1 41 1 1 1 1 1 1 1 1 1 1 46 47 48 49 1 1 1 1 30 31 32 33 10 11 12 13 1 1 1 1 46 47 48 49 1 1 1 1 1 1 22 23 24 25 22 23 24 25 1 1 1 1 1 1 
1 1 42 1 1 45 34 35 36 37 18 19 20 21 18 19 20 21 34 35 36 37 1 1 1 1 1 1 10 11 12 13 1 1 1 1 1 1 34 35 36 37 1 1 1 1 26 27 28 29 26 27 28 29 1 1 1 1 1 1 
1 1 46 47 48 49 38 39 1 41 22 23 24 25 22 23 24 25 38 39 1 41 1 1 1 1 1 1 10 11 12 13 1 1 1 1 1 1 38 39 1 41 1 1 1 1 30 31 32 33 30 31 32 33 1 1 1 1 1 1 
1 1 1 1 1 1 42 1 1 45 26 27 28 29 26 27 28 29 42 1 1 45 1 1 1 1 1 1 10 11 12 13 1 1 1 1 1 1 42 1 1 45 1 1 1 1 1 1 1 1 1 1 1 1 1 1 1 1 1 1 
1 1 1 1 1 1 46 47 48 49 30 31 32 33 30 31 32 33 46 47 48 49 1 1 1 1 1 1 10 11 12 13 1 1 1 1 1 1 46 47 48 49 1 1 1 1 1 1 1 1 1 1 1 1 1 1 1 1 1 1 
1 1 1 1 1 1 1 1 1 1 18 19 20 21 18 19 20 21 1 34 35 36 37 1 1 1 1 1 10 11 12 13 18 19 20 21 1 1 1 1 34 35 36 37 1 1 34 35 36 37 1 1 1 1 1 1 1 1 1 1 
1 1 1 1 1 1 1 1 1 1 22 23 24 25 22 23 24 25 1 38 39 1 41 1 1 1 1 1 10 11 12 13 22 23 24 25 1 1 1 1 38 39 1 41 1 1 38 39 1 41 1 1 1 1 1 1 1 1 1 1 
1 1 1 1 1 1 1 1 1 1 26 27 28 29 26 27 28 29 1 42 1 1 45 1 1 1 1 1 10 11 12 13 26 27 28 29 1 1 1 1 42 1 1 45 1 1 42 1 1 45 1 1 1 1 1 1 1 1 1 1 
1 1 1 1 1 1 1 1 1 1 30 31 32 33 30 31 32 33 1 46 47 48 49 1 1 1 1 1 10 11 12 13 30 31 32 33 1 1 1 1 46 47 48 49 1 1 46 47 48 49 1 1 1 1 1 1 1 1 1 1 
1 1 1 1 1 34 35 36 37 1 1 1 1 1 1 1 1 1 1 1 1 34 35 36 37 1 1 1 10 11 12 13 1 1 1 1 34 35 36 37 1 1 1 1 1 1 1 1 1 1 1 34 35 36 37 1 1 1 1 1 
1 1 1 1 1 38 39 1 41 1 1 1 1 1 1 1 1 1 1 1 1 38 39 1 41 1 1 1 10 11 12 13 1 1 1 1 38 39 1 41 1 1 1 1 1 1 1 1 1 1 1 38 39 1 41 1 1 1 1 1 
1 1 1 1 1 42 1 1 45 1 1 34 35 36 37 1 1 1 1 1 1 42 1 1 45 1 1 1 10 11 12 13 1 1 1 1 42 1 1 45 1 1 1 1 34 35 36 37 1 1 1 42 1 1 45 1 1 1 1 1 
1 1 1 1 1 46 47 48 49 1 1 38 39 1 41 1 1 1 1 1 1 46 47 48 49 1 1 1 10 11 12 13 1 1 1 1 46 47 48 49 1 1 1 1 38 39 1 41 1 1 1 46 47 48 49 1 1 1 1 1 
1 1 1 1 1 1 1 1 1 1 1 42 1 1 45 1 1 1 1 1 1 1 1 1 34 35 36 37 10 11 12 13 34 35 36 37 1 1 1 1 1 1 1 1 42 1 1 45 1 1 1 1 1 1 1 1 1 1 1 1 
1 1 1 1 1 1 1 1 1 1 1 46 47 48 49 1 1 1 1 1 1 1 1 1 38 39 1 41 10 11 12 13 38 39 1 41 1 1 1 1 1 1 1 1 46 47 48 49 1 1 1 1 1 1 1 1 1 1 1 1 
1 1 1 1 1 1 1 1 1 1 1 1 1 1 1 1 1 1 34 35 36 37 1 1 42 1 1 45 14 15 16 17 42 1 1 45 1 1 1 34 35 36 37 1 1 1 1 1 1 1 1 34 35 36 37 1 1 1 1 1 
1 1 1 1 1 1 1 1 1 1 1 34 35 36 37 1 1 1 38 39 1 41 1 1 46 47 48 49 1 50 1 1 46 47 48 49 1 1 1 38 39 1 41 1 1 1 1 1 1 1 1 38 39 1 41 1 1 1 1 1 
1 1 1 1 1 34 35 36 37 1 1 38 39 1 41 1 1 1 42 1 1 45 1 1 1 1 1 1 18 19 20 21 1 1 1 1 1 1 1 42 1 1 45 1 1 34 35 36 37 1 1 42 1 1 45 1 1 1 1 1 
1 1 1 1 1 38 39 1 41 1 1 42 1 1 45 1 1 1 46 47 48 49 1 1 1 1 1 1 22 23 24 25 1 1 1 1 1 1 1 46 47 48 49 1 1 38 39 1 41 1 1 46 47 48 49 1 1 1 1 1 
1 1 1 1 1 42 1 1 45 1 1 46 47 48 49 1 1 1 1 1 1 1 1 1 18 19 20 21 26 27 28 29 18 19 20 21 1 1 1 1 1 1 1 1 1 42 1 1 45 1 1 1 1 1 1 1 1 1 1 1 
1 1 1 1 1 46 47 48 49 1 1 1 1 1 1 1 1 1 1 1 18 19 20 21 22 23 24 25 30 31 32 33 22 23 24 25 18 19 20 21 1 1 1 1 1 46 47 48 49 1 1 1 1 1 1 1 1 1 1 1 
1 1 1 1 1 1 1 1 1 1 1 1 1 1 1 1 1 1 1 1 22 23 24 25 26 27 28 29 18 19 20 21 26 27 28 29 22 23 24 25 1 1 1 1 1 1 1 1 1 1 1 1 1 1 1 1 1 1 1 1 
1 1 1 1 1 1 1 1 1 1 1 1 1 1 1 1 1 1 1 1 26 27 28 29 30 31 32 33 22 23 24 25 30 31 32 33 26 27 28 29 1 1 1 1 1 1 1 1 1 1 1 1 1 1 1 1 1 1 1 1 
1 1 1 1 1 1 1 1 1 1 1 1 1 1 1 1 18 19 20 21 30 31 32 33 18 19 20 21 26 27 28 29 18 19 20 21 30 31 32 33 18 19 20 21 1 1 1 1 1 1 1 1 1 1 1 1 1 1 1 1 
1 1 1 1 1 1 1 1 1 1 1 1 1 1 1 1 22 23 24 25 18 19 20 21 22 23 24 25 30 31 32 33 22 23 24 25 18 19 20 21 22 23 24 25 1 1 1 1 1 1 1 1 1 1 1 1 1 1 1 1 
1 1 1 1 1 1 1 1 1 1 1 1 18 19 20 21 26 27 28 29 22 23 24 25 26 27 28 29 18 19 20 21 26 27 28 29 22 23 24 25 26 27 28 29 18 19 20 21 1 1 1 1 1 1 1 1 1 1 1 1 
1 1 1 1 1 1 1 1 18 19 20 21 22 23 24 25 30 31 32 33 26 27 28 29 30 31 32 33 22 23 24 25 30 31 32 33 26 27 28 29 30 31 32 33 22 23 24 25 18 19 20 21 1 1 1 1 1 1 1 1