19 19 19 19 19 19 19 19 19 19 19 19 19 19 19 19 19 19 19 19 19 19 1 1 32 33 20 29 29 29 29 29 29 18 32 33 1 1 19 19 19 19 19 19 19 19 19 19 19 19 19 19 19 19 19 19 19 19 19 19 
19 19 19 19 19 19 19 19 19 19 19 19 19 19 19 19 19 19 19 19 19 19 1 1 34 35 20 29 29 29 29 29 29 18 34 35 1 1 19 19 19 19 19 19 19 19 19 19 19 19 19 19 19 19 19 19 19 19 19 19 
19 19 19 19 19 19 19 19 19 19 19 19 19 19 19 19 19 19 19 19 19 19 1 1 36 37 20 29 29 29 29 29 29 18 36 37 1 1 19 19 19 19 19 19 19 19 19 19 19 19 19 19 19 19 19 19 19 19 19 19 
19 19 19 19 19 19 19 19 19 19 19 19 19 19 19 19 19 19 19 19 19 19 1 1 32 33 20 29 29 29 29 29 29 18 32 33 1 1 19 19 19 19 19 19 19 19 19 19 19 19 19 19 19 19 19 19 19 19 19 19 
19 19 19 19 19 19 19 19 19 19 19 19 19 19 19 19 19 19 19 19 19 19 1 1 34 35 20 29 29 29 29 29 29 18 34 35 1 1 19 19 19 19 19 19 19 19 19 19 19 19 19 19 19 19 19 19 19 19 19 19 
19 19 19 19 19 19 19 19 19 19 19 19 19 19 19 19 19 19 19 19 19 19 1 1 36 37 20 29 29 56 29 29 29 18 36 37 1 1 19 19 19 19 19 19 19 19 19 19 19 19 19 19 19 19 19 19 19 19 19 19 
19 19 19 19 19 19 19 19 19 19 19 19 19 19 19 19 19 19 19 19 19 19 1 1 32 33 20 29 29 29 29 29 29 18 32 33 1 1 19 19 19 19 19 19 19 19 19 19 19 19 19 19 19 19 19 19 19 19 19 19 
19 19 19 19 19 19 19 19 19 19 19 19 19 19 19 19 19 19 19 19 19 19 1 1 34 35 20 29 29 29 29 29 29 18 34 35 1 1 19 19 19 19 19 19 19 19 19 19 19 19 19 19 19 19 19 19 19 19 19 19 
19 19 19 19 19 19 19 19 19 19 19 19 19 19 19 19 19 19 19 19 19 19 1 1 36 37 20 29 29 29 29 29 29 18 36 37 1 1 19 19 19 19 19 19 19 19 19 19 19 19 19 19 19 19 19 19 19 19 19 19 
19 19 19 19 19 19 19 19 19 19 19 19 19 19 19 19 19 19 19 19 19 19 1 1 32 33 20 29 29 29 29 29 29 18 32 33 1 1 19 19 19 19 19 19 19 19 19 19 19 19 19 19 19 19 19 19 19 19 19 19 
19 19 19 19 19 19 19 19 19 19 19 19 19 19 19 19 19 19 19 19 19 19 1 1 34 35 20 28 28 28 28 28 28 18 34 35 1 1 19 19 19 19 19 19 19 19 19 19 19 19 19 19 19 19 19 19 19 19 19 19 
19 19 19 19 19 19 19 19 19 19 19 19 19 19 19 19 19 19 19 19 19 19 1 1 36 37 20 28 28 28 28 28 28 18 36 37 1 1 19 19 19 19 19 19 19 19 19 19 19 19 19 19 19 19 19 19 19 19 19 19 
19 19 19 19 19 19 19 19 19 19 19 19 19 19 19 19 19 19 19 19 19 19 1 1 32 33 20 28 28 28 28 28 28 18 32 33 1 1 19 19 19 19 19 19 19 19 19 19 19 19 19 19 19 19 19 19 19 19 19 19 
19 19 19 19 19 19 19 19 19 19 19 19 19 19 19 19 19 19 19 19 19 19 1 1 34 35 20 28 28 28 28 28 28 18 34 35 1 1 19 19 19 19 19 19 19 19 19 19 19 19 19 19 19 19 19 19 19 19 19 19 
19 19 19 19 19 19 19 19 19 19 19 19 19 19 19 19 19 19 19 19 19 19 1 1 36 37 20 28 28 28 28 28 28 18 36 37 1 1 19 19 19 19 19 19 19 19 19 19 19 19 19 19 19 19 19 19 19 19 19 19 
19 19 19 19 19 19 19 19 19 19 19 19 19 19 19 19 19 19 19 19 19 19 1 1 32 33 20 28 28 28 28 28 28 18 32 33 1 1 19 19 19 19 19 19 19 19 19 19 19 19 19 19 19 19 19 19 19 19 19 19 
19 19 19 19 19 19 19 19 19 19 19 19 19 19 19 19 19 19 19 19 1 1 1 1 34 35 20 28 28 28 28 28 28 18 34 35 1 1 1 1 19 19 19 19 19 19 19 19 19 19 19 19 19 19 19 19 19 19 19 19 
19 19 19 19 19 19 19 19 19 19 19 19 19 19 19 19 19 19 19 19 1 1 1 1 36 37 20 28 28 28 28 28 28 18 36 37 1 1 1 1 19 19 19 19 19 19 19 19 19 19 19 19 19 19 19 19 19 19 19 19 
19 19 19 19 19 19 19 19 19 19 19 19 19 19 19 19 19 19 1 1 32 33 32 33 32 33 20 28 28 28 28 28 28 18 32 33 32 33 32 33 1 1 19 19 19 19 19 19 19 19 19 19 19 19 19 19 19 19 19 19 
19 19 19 19 19 19 19 19 19 19 19 19 19 19 19 19 19 19 1 1 34 35 34 35 34 35 20 28 28 28 28 28 28 18 34 35 34 35 34 35 1 1 19 19 19 19 19 19 19 19 19 19 19 19 19 19 19 19 19 19 
19 19 19 19 19 19 19 19 19 19 19 19 19 19 19 19 19 19 1 1 36 37 36 37 36 37 20 28 28 28 28 28 28 18 36 37 36 37 36 37 1 1 19 19 19 19 19 19 19 19 19 19 19 19 19 19 19 19 19 19 
19 1 1 1 1 1 1 1 1 1 1 1 1 1 1 1 1 1 1 32 33 26 22 22 22 22 23 28 28 28 28 28 28 21 22 22 22 22 24 32 33 1 1 1 1 1 1 1 1 1 1 1 1 1 1 1 1 1 1 19 
19 1 1 1 1 1 1 1 1 1 1 1 1 1 1 1 1 1 1 34 35 20 28 28 28 28 28 28 28 28 28 28 28 28 28 28 28 28 18 34 35 1 1 1 1 1 1 1 1 1 1 1 1 1 1 1 1 1 1 19 
19 32 33 32 33 32 33 32 33 32 33 32 33 32 33 32 33 32 33 36 37 20 28 28 28 28 28 28 28 28 28 28 28 28 28 28 28 28 18 36 37 32 33 32 33 32 33 32 33 32 33 32 33 32 33 32 33 32 33 19 
19 34 35 34 35 34 35 34 35 34 35 34 35 34 35 34 35 34 35 19 19 20 28 28 28 28 28 28 28 28 28 28 28 28 28 28 28 28 18 19 19 34 35 34 35 34 35 34 35 34 35 34 35 34 35 34 35 34 35 19 
19 36 37 36 37 36 37 36 37 36 37 36 37 36 37 36 37 36 37 19 14 20 28 28 28 15 16 16 17 28 28 15 16 16 17 28 28 28 18 14 19 36 37 36 37 36 37 36 37 36 37 36 37 36 37 36 37 36 37 19 
22 22 22 22 22 22 22 22 22 22 22 22 22 22 22 22 22 22 22 22 22 23 28 28 28 18 14 14 20 28 28 18 14 14 20 28 28 28 21 22 22 22 22 22 22 22 22 22 22 22 22 22 22 22 22 22 22 22 22 22 
29 29 29 29 29 29 29 29 29 29 28 28 28 28 28 28 28 28 28 28 28 28 28 28 28 18 14 38 39 39 39 39 40 14 20 28 28 28 28 28 28 28 28 28 28 28 28 28 28 28 29 29 29 29 29 29 29 29 29 29 
29 29 29 29 29 29 29 29 29 55 28 28 28 28 28 28 28 28 28 28 28 28 28 28 28 21 22 41 42 42 42 42 43 22 23 28 28 28 28 28 28 28 28 28 28 28 28 28 28 28 57 29 29 29 29 29 29 29 29 29 
29 29 29 29 29 29 29 29 29 29 28 28 28 28 28 28 28 28 28 28 28 28 51 52 28 28 28 41 42 42 42 42 43 28 28 28 47 48 28 28 28 28 28 28 28 28 28 28 28 28 29 29 29 29 29 29 29 29 29 29 
29 29 29 29 29 29 29 29 29 29 28 28 28 28 28 28 28 28 28 28 28 28 53 54 28 28 28 41 42 42 42 42 43 28 28 28 49 50 28 28 28 28 28 28 28 28 28 28 28 28 29 29 29 29 29 29 29 29 29 29 
29 29 29 29 29 29 29 29 29 29 28 28 28 28 28 28 28 28 28 28 28 28 28 28 28 15 16 41 42 42 42 42 43 16 17 28 28 28 28 28 28 28 28 28 28 28 28 28 28 28 29 29 29 29 29 29 29 29 29 29 
29 29 29 29 29 29 29 29 29 29 28 28 28 28 28 28 28 28 28 28 28 28 28 28 28 18 14 44 45 45 45 45 46 14 20 28 28 28 28 28 28 28 28 28 28 28 28 28 28 28 29 29 29 29 29 29 29 29 29 29 
16 16 16 16 16 16 16 16 16 16 16 16 16 16 16 16 16 16 16 16 16 17 28 28 28 18 14 14 20 28 28 18 14 14 20 28 28 28 15 16 16 16 16 16 16 16 16 16 16 16 16 16 16 16 16 16 16 16 16 16 
19 32 33 32 33 32 33 32 33 32 33 32 33 32 33 32 33 32 33 19 14 20 28 28 28 21 22 22 23 28 28 21 22 22 23 28 28 28 18 14 19 32 33 32 33 32 33 32 33 32 33 32 33 32 33 32 33 32 33 19 
19 34 35 34 35 34 35 34 35 34 35 34 35 34 35 34 35 34 35 19 19 20 28 28 28 28 28 28 28 28 28 28 28 28 28 28 28 28 18 19 19 34 35 34 35 34 35 34 35 34 35 34 35 34 35 34 35 34 35 19 
19 36 37 36 37 36 37 36 37 36 37 36 37 36 37 36 37 36 37 32 33 20 28 28 28 28 28 28 28 28 28 28 28 28 28 28 28 28 18 32 33 36 37 36 37 36 37 36 37 36 37 36 37 36 37 36 37 36 37 19 
19 1 1 1 1 1 1 1 1 1 1 1 1 1 1 1 1 1 1 34 35 20 28 28 28 28 28 28 28 28 28 28 28 28 28 28 28 28 18 34 35 1 1 1 1 1 1 1 1 1 1 1 1 1 1 1 1 1 1 19 
19 1 1 1 1 1 1 1 1 1 1 1 1 1 1 1 1 1 1 36 37 27 16 16 16 16 17 28 28 28 28 28 28 15 16 16 16 16 25 36 37 1 1 1 1 1 1 1 1 1 1 1 1 1 1 1 1 1 1 19 
19 19 19 19 19 19 19 19 19 19 19 19 19 19 19 19 19 19 1 1 32 33 32 33 32 33 20 28 28 28 28 28 28 18 32 33 32 33 32 33 1 1 19 19 19 19 19 19 19 19 19 19 19 19 19 19 19 19 19 19 
19 19 19 19 19 19 19 19 19 19 19 19 19 19 19 19 19 19 1 1 34 35 34 35 34 35 20 28 28 28 28 28 28 18 34 35 34 35 34 35 1 1 19 19 19 19 19 19 19 19 19 19 19 19 19 19 19 19 19 19 
19 19 19 19 19 19 19 19 19 19 19 19 19 19 19 19 19 19 1 1 36 37 36 37 36 37 20 28 28 28 28 28 28 18 36 37 36 37 36 37 1 1 19 19 19 19 19 19 19 19 19 19 19 19 19 19 19 19 19 19 
19 19 19 19 19 19 19 19 19 19 19 19 19 19 19 19 19 19 19 19 1 1 1 1 32 33 20 28 28 28 28 28 28 18 32 33 1 1 1 1 19 19 19 19 19 19 19 19 19 19 19 19 19 19 19 19 19 19 19 19 
19 19 19 19 19 19 19 19 19 19 19 19 19 19 19 19 19 19 19 19 1 1 1 1 34 35 20 28 28 28 28 28 28 18 34 35 1 1 1 1 19 19 19 19 19 19 19 19 19 19 19 19 19 19 19 19 19 19 19 19 
19 19 19 19 19 19 19 19 19 19 19 19 19 19 19 19 19 19 19 19 19 19 1 1 36 37 20 28 28 28 28 28 28 18 36 37 1 1 19 19 19 19 19 19 19 19 19 19 19 19 19 19 19 19 19 19 19 19 19 19 
19 19 19 19 19 19 19 19 19 19 19 19 19 19 19 19 19 19 19 19 19 19 1 1 32 33 20 28 28 28 28 28 28 18 32 33 1 1 19 19 19 19 19 19 19 19 19 19 19 19 19 19 19 19 19 19 19 19 19 19 
19 19 19 19 19 19 19 19 19 19 19 19 19 19 19 19 19 19 19 19 19 19 1 1 34 35 20 28 28 28 28 28 28 18 34 35 1 1 19 19 19 19 19 19 19 19 19 19 19 19 19 19 19 19 19 19 19 19 19 19 
19 19 19 19 19 19 19 19 19 19 19 19 19 19 19 19 19 19 19 19 19 19 1 1 36 37 20 28 28 28 28 28 28 18 36 37 1 1 19 19 19 19 19 19 19 19 19 19 19 19 19 19 19 19 19 19 19 19 19 19 
19 19 19 19 19 19 19 19 19 19 19 19 19 19 19 19 19 19 19 19 19 19 1 1 32 33 20 28 28 28 28 28 28 18 32 33 1 1 19 19 19 19 19 19 19 19 19 19 19 19 19 19 19 19 19 19 19 19 19 19 
19 19 19 19 19 19 19 19 19 19 19 19 19 19 19 19 19 19 19 19 19 19 1 1 34 35 20 28 28 28 28 28 28 18 34 35 1 1 19 19 19 19 19 19 19 19 19 19 19 19 19 19 19 19 19 19 19 19 19 19 
19 19 19 19 19 19 19 19 19 19 19 19 19 19 19 19 19 19 19 19 19 19 1 1 36 37 20 29 29 29 29 29 29 18 36 37 1 1 19 19 19 19 19 19 19 19 19 19 19 19 19 19 19 19 19 19 19 19 19 19 
19 19 19 19 19 19 19 19 19 19 19 19 19 19 19 19 19 19 19 19 19 19 1 1 32 33 20 29 29 29 29 29 29 18 32 33 1 1 19 19 19 19 19 19 19 19 19 19 19 19 19 19 19 19 19 19 19 19 19 19 
19 19 19 19 19 19 19 19 19 19 19 19 19 19 19 19 19 19 19 19 19 19 1 1 34 35 20 29 29 29 29 29 29 18 34 35 1 1 19 19 19 19 19 19 19 19 19 19 19 19 19 19 19 19 19 19 19 19 19 19 
19 19 19 19 19 19 19 19 19 19 19 19 19 19 19 19 19 19 19 19 19 19 1 1 36 37 20 29 29 29 29 29 29 18 36 37 1 1 19 19 19 19 19 19 19 19 19 19 19 19 19 19 19 19 19 19 19 19 19 19 
19 19 19 19 19 19 19 19 19 19 19 19 19 19 19 19 19 19 19 19 19 19 1 1 32 33 20 29 29 29 29 29 29 18 32 33 1 1 19 19 19 19 19 19 19 19 19 19 19 19 19 19 19 19 19 19 19 19 19 19 
19 19 19 19 19 19 19 19 19 19 19 19 19 19 19 19 19 19 19 19 19 19 1 1 34 35 20 29 29 29 29 29 29 18 34 35 1 1 19 19 19 19 19 19 19 19 19 19 19 19 19 19 19 19 19 19 19 19 19 19 
19 19 19 19 19 19 19 19 19 19 19 19 19 19 19 19 19 19 19 19 19 19 1 1 36 37 20 29 29 29 29 29 29 18 36 37 1 1 19 19 19 19 19 19 19 19 19 19 19 19 19 19 19 19 19 19 19 19 19 19 
19 19 19 19 19 19 19 19 19 19 19 19 19 19 19 19 19 19 19 19 19 19 1 1 32 33 20 29 29 29 29 29 29 18 32 33 1 1 19 19 19 19 19 19 19 19 19 19 19 19 19 19 19 19 19 19 19 19 19 19 
19 19 19 19 19 19 19 19 19 19 19 19 19 19 19 19 19 19 19 19 19 19 1 1 34 35 20 29 29 29 29 29 29 18 34 35 1 1 19 19 19 19 19 19 19 19 19 19 19 19 19 19 19 19 19 19 19 19 19 19 
19 19 19 19 19 19 19 19 19 19 19 19 19 19 19 19 19 19 19 19 19 19 1 1 36 37 20 29 29 29 29 29 29 18 36 37 1 1 19 19 19 19 19 19 19 19 19 19 19 19 19 19 19 19 19 19 19 19 19 19