5 6 6 6 6 6 6 6 6 6 6 6 6 6 6 6 6 6 6 6 6 6 6 6 6 6 6 6 6 6 6 6 6 6 6 6 6 6 6 6 6 6 6 6 6 6 6 6 6 7 
8 9 9 9 9 9 9 9 9 9 9 9 9 9 9 9 9 9 9 9 9 9 9 9 9 9 9 9 9 9 9 9 9 9 9 9 9 9 9 9 9 9 9 9 9 9 9 9 9 10 
8 9 9 9 9 9 9 9 9 9 27 28 9 9 19 20 20 20 20 20 20 20 20 21 9 9 9 9 9 9 9 27 28 9 9 9 9 9 9 9 9 9 9 9 9 9 9 9 9 10 
8 9 9 9 9 27 28 9 9 9 29 30 9 9 22 23 23 23 23 23 23 23 23 24 9 9 9 9 9 9 9 29 30 9 9 9 9 9 9 9 9 9 9 9 9 9 9 9 9 10 
8 9 9 9 9 29 30 27 28 9 31 32 9 9 22 23 23 23 23 23 23 23 23 24 9 9 9 9 9 9 9 31 32 9 9 9 9 9 9 9 9 9 9 9 9 9 9 9 9 10 
8 27 28 9 9 31 32 29 30 9 9 9 9 9 22 23 23 23 23 23 23 23 23 24 9 9 9 27 28 9 9 9 9 9 9 9 9 9 9 9 9 9 9 9 9 9 9 9 9 10 
8 29 30 27 28 9 9 31 32 27 28 9 9 9 22 23 23 23 23 23 23 23 23 24 9 9 9 29 30 9 9 9 9 9 9 9 9 9 9 9 9 9 9 9 9 9 9 9 9 10 
8 31 32 29 30 9 9 27 28 29 30 9 9 9 22 23 23 23 23 23 23 23 23 24 33 9 9 31 32 9 9 9 9 27 28 9 9 9 9 9 9 9 9 9 9 9 9 9 9 10 
8 9 9 31 32 27 28 29 30 31 32 27 28 9 22 23 23 23 23 23 23 23 23 24 33 33 33 9 9 9 9 9 9 29 30 9 9 9 9 9 9 9 9 9 9 9 9 9 9 10 
8 27 28 9 9 29 30 31 32 9 9 29 30 9 22 23 23 23 23 23 23 23 23 24 33 33 33 33 9 9 9 9 9 31 32 9 9 9 9 9 9 9 9 9 9 9 9 9 9 10 
8 29 30 27 28 31 32 9 9 9 9 31 32 9 25 26 26 26 26 26 26 26 26 1 33 33 33 33 33 33 33 9 9 9 9 9 19 20 20 20 20 20 20 20 20 21 9 9 9 10 
8 31 32 29 30 9 9 9 9 9 9 9 9 9 2 3 3 3 3 3 3 3 3 4 9 33 33 33 33 33 33 33 33 33 33 9 22 23 23 23 23 23 23 23 23 24 9 27 28 10 
8 9 9 31 32 9 9 9 9 9 9 9 9 9 9 9 9 9 9 9 9 9 9 9 9 9 33 33 9 9 33 33 33 33 33 9 22 23 23 23 23 23 23 23 23 24 9 29 30 10 
8 9 9 9 9 9 9 9 9 9 9 9 9 9 34 9 9 9 9 9 9 9 9 9 9 9 9 9 9 9 33 33 33 33 33 9 22 23 23 23 23 23 23 23 23 24 9 31 32 10
8 9 9 9 9 9 9 9 9 9 9 34 9 9 9 9 9 9 9 9 9 34 9 9 9 9 9 9 9 9 9 9 33 33 33 33 22 23 23 23 23 23 23 23 23 24 27 28 9 10
8 9 9 9 9 9 9 9 9 9 9 9 9 9 9 9 9 34 9 9 9 9 9 9 9 9 34 9 9 9 9 9 33 33 33 33 22 23 23 23 23 23 23 23 23 24 29 30 9 10
8 9 9 9 9 9 9 9 9 9 9 9 9 9 9 9 9 9 9 9 9 9 9 9 9 9 9 9 9 9 9 9 9 33 33 33 22 23 23 23 23 23 23 23 23 24 31 32 9 10
8 9 9 9 9 9 9 9 9 9 9 9 9 9 9 9 9 9 9 9 9 9 9 9 9 9 9 9 9 9 34 9 9 9 9 33 22 23 23 23 23 23 23 23 23 24 9 27 28 10
8 9 9 9 35 9 9 9 9 9 9 9 9 9 9 9 9 9 9 9 9 9 9 9 9 9 9 9 9 9 9 9 9 9 34 9 25 26 26 26 26 26 26 26 26 1 9 29 30 10
11 12 12 12 12 14 9 9 9 9 9 9 9 9 9 9 9 9 9 9 9 9 9 9 9 9 9 9 9 9 9 9 9 9 9 9 2 3 3 3 3 3 3 3 3 4 9 31 32 10
18 18 18 18 18 8 9 9 9 9 9 9 9 9 9 9 9 9 9 9 9 9 9 9 9 9 9 9 9 9 9 9 9 9 9 9 9 9 9 9 9 9 9 9 9 9 9 34 9 10
18 18 18 18 18 8 9 9 9 9 9 9 9 9 9 9 9 9 9 9 9 9 9 9 9 9 9 9 9 9 9 9 9 9 9 9 9 9 9 9 9 9 9 9 34 9 34 9 9 10
18 18 18 18 18 8 9 9 9 9 9 9 9 9 9 9 9 9 9 9 9 9 9 9 9 9 9 9 9 9 9 9 9 9 9 9 9 9 9 9 9 9 9 9 9 9 9 34 9 10
18 18 18 18 18 8 9 9 9 9 9 9 9 9 9 9 9 9 9 9 9 9 9 9 9 9 9 9 9 9 9 9 9 9 9 9 9 9 9 9 9 9 9 9 9 9 9 9 9 10
18 18 18 18 18 8 9 9 9 9 9 9 9 9 9 9 9 9 9 9 9 9 9 9 9 9 9 9 9 9 9 9 9 9 9 9 9 9 9 9 9 9 9 9 9 9 9 9 9 10
18 18 18 18 18 8 9 9 9 9 9 9 9 9 9 9 9 9 9 9 9 9 9 9 9 9 9 9 9 9 9 9 9 9 9 9 9 9 9 9 9 9 9 9 9 9 9 9 9 10
5 6 6 6 6 15 9 9 9 9 9 9 9 9 9 9 9 9 9 9 9 9 9 9 9 9 9 9 9 9 9 9 9 9 9 9 9 9 9 9 9 9 9 9 9 9 9 9 9 10
8 9 9 9 9 9 9 9 9 9 9 9 9 9 9 9 9 9 9 9 9 9 9 9 9 9 9 9 9 9 9 9 9 9 9 9 9 9 9 9 9 9 9 9 9 9 9 9 9 10
8 9 9 9 9 34 9 9 9 9 9 9 9 9 9 9 9 9 9 9 9 9 9 9 9 9 9 9 9 9 9 9 9 9 9 9 9 9 9 9 9 9 9 9 9 9 9 9 9 10
8 9 9 9 9 9 9 9 9 9 34 9 9 9 9 9 9 9 9 9 9 9 9 9 9 9 9 9 9 9 9 9 9 9 9 9 9 9 9 9 9 9 9 9 9 9 9 9 9 10
8 9 9 9 9 9 9 34 9 9 9 9 9 9 9 9 9 9 9 9 9 9 9 9 9 9 9 9 9 9 9 9 9 9 9 9 9 9 9 9 9 9 9 9 9 9 9 9 9 10
8 9 33 33 9 9 9 9 9 9 9 9 34 9 27 28 9 9 9 9 9 9 9 9 9 9 9 9 9 9 9 9 9 9 9 9 9 9 9 9 9 9 9 36 9 9 34 34 34 10
8 33 33 33 19 20 20 20 20 20 20 20 20 21 29 30 9 9 9 9 9 9 9 9 9 9 9 9 9 9 9 9 9 9 9 9 9 9 9 9 9 9 9 9 16 12 12 12 12 13
8 33 33 33 22 23 23 23 23 23 23 23 23 24 31 32 9 9 27 28 9 9 9 9 9 9 9 9 9 9 9 9 9 9 9 9 9 9 9 9 9 9 9 9 10 18 18 18 18 18
8 33 33 9 22 23 23 23 23 23 23 23 23 24 9 9 27 28 29 30 9 9 9 9 9 34 9 9 9 9 9 9 9 9 9 9 9 9 9 9 9 9 9 9 10 18 18 18 18 18
8 9 9 9 22 23 23 23 23 23 23 23 23 24 27 28 29 30 31 32 27 28 9 9 9 9 9 9 9 9 34 9 9 9 9 9 9 9 9 9 34 9 9 9 10 18 18 18 18 18
8 9 9 9 22 23 23 23 23 23 23 23 23 24 29 30 31 32 9 9 29 30 9 9 27 28 9 9 9 9 9 9 9 9 9 34 9 9 9 9 9 9 9 9 10 18 18 18 18 18
8 9 9 9 22 23 23 23 23 23 23 23 23 24 31 32 9 9 9 9 31 32 9 9 29 30 9 9 27 28 9 9 9 9 9 9 9 9 9 9 9 9 9 9 10 18 18 18 18 18
8 9 9 9 22 23 23 23 23 23 23 23 23 24 9 9 9 27 28 9 9 9 27 28 31 32 9 9 29 30 9 34 9 34 9 9 34 9 34 9 9 9 9 9 10 18 18 18 18 18
8 9 9 9 22 23 23 23 23 23 23 23 23 24 9 9 9 29 30 9 9 9 29 30 9 9 27 28 31 32 9 9 9 19 20 20 20 20 20 20 20 20 21 9 17 6 6 6 6 7
8 9 9 9 25 26 26 26 26 26 26 26 26 1 9 9 9 31 32 9 9 9 31 32 9 9 29 30 9 9 27 28 9 22 23 23 23 23 23 23 23 23 24 33 9 9 34 34 34 10
8 9 9 9 2 3 3 3 3 3 3 3 3 4 9 27 28 9 9 9 27 28 9 9 9 9 31 32 9 9 29 30 9 22 23 23 23 23 23 23 23 23 24 33 33 33 9 9 9 10 
8 9 9 9 9 9 9 9 9 9 9 9 9 9 9 29 30 9 9 9 29 30 9 27 28 9 9 9 27 28 31 32 9 22 23 23 23 23 23 23 23 23 24 33 33 33 9 9 9 10 
8 9 9 9 9 9 9 9 9 9 9 9 9 9 9 31 32 9 9 9 31 32 9 29 30 9 9 9 29 30 9 9 9 22 23 23 23 23 23 23 23 23 24 9 33 33 33 33 9 10 
8 9 9 9 9 9 9 9 9 9 9 9 9 9 9 9 9 9 9 9 9 9 9 31 32 27 28 9 31 32 9 9 9 22 23 23 23 23 23 23 23 23 24 9 33 33 33 33 33 10 
8 9 9 9 9 9 9 9 9 9 9 9 9 9 9 9 9 9 9 9 9 9 9 9 9 29 30 9 9 9 9 9 9 22 23 23 23 23 23 23 23 23 24 9 9 33 33 33 33 10 
8 9 9 9 9 9 9 9 9 9 9 9 9 9 9 9 9 9 9 9 9 9 9 9 9 31 32 9 9 9 9 9 9 22 23 23 23 23 23 23 23 23 24 9 9 9 9 33 33 10 
8 9 9 9 9 9 9 9 9 9 9 9 9 9 9 9 9 9 9 9 9 9 9 9 9 9 9 9 9 9 9 9 9 25 26 26 26 26 26 26 26 26 1 9 9 9 9 9 33 10 
8 9 9 9 9 9 9 9 9 9 9 9 9 9 9 9 9 9 9 9 9 9 9 9 9 9 9 9 9 9 9 9 9 2 3 3 3 3 3 3 3 3 4 9 9 9 9 9 9 10 
11 12 12 12 12 12 12 12 12 12 12 12 12 12 12 12 12 12 12 12 12 12 12 12 12 12 12 12 12 12 12 12 12 12 12 12 12 12 12 12 12 12 12 12 12 12 12 12 12 13