22 22 22 22 22 22 22 22 22 3 4 4 5 22 22 22 22 3 4 4 5 22 22 22 22 22 22 22 22 22 22 22 22 22 22 22 22 3 4 4 5 22 22 22 22 22 22 22 22 22 22 22 22 22 22 22 22 22 22 22 
22 3 4 4 5 22 22 22 22 6 7 7 8 3 4 4 5 6 7 7 8 22 22 22 22 3 4 4 5 22 22 22 22 22 22 22 22 6 7 7 8 22 22 22 22 22 22 22 22 22 22 22 22 22 22 22 22 22 22 22 
22 6 7 7 8 3 4 4 5 6 7 7 8 6 7 7 8 6 7 7 8 22 22 22 22 6 7 7 8 3 4 4 5 22 22 22 22 6 7 7 8 22 22 22 22 22 22 22 22 22 22 22 22 22 22 22 22 22 22 22 
22 6 7 7 8 6 7 7 8 9 10 10 11 6 7 7 8 9 10 10 11 3 4 4 5 6 7 7 8 6 7 7 8 22 22 22 22 9 10 10 11 22 22 22 22 22 22 22 22 22 22 22 22 22 22 22 22 22 22 22 
22 9 10 10 11 6 7 7 8 12 13 13 14 9 10 10 11 12 13 13 14 6 7 7 8 9 10 10 11 6 7 7 8 22 22 22 22 12 13 13 14 22 22 22 22 22 22 22 22 22 22 22 22 22 22 22 22 22 22 22 
22 12 13 13 14 9 10 10 11 12 13 13 14 12 13 13 14 12 13 13 14 6 7 7 8 12 13 13 14 9 10 10 11 22 22 22 22 12 13 13 14 22 3 4 4 5 22 22 22 22 3 4 4 5 22 22 22 22 22 22 
22 12 13 13 14 12 13 13 14 15 16 16 17 12 13 13 14 15 16 16 17 9 10 10 11 12 13 13 14 12 13 13 14 3 4 4 5 15 16 16 17 22 6 7 7 8 22 22 22 22 6 7 7 8 22 22 22 22 22 22 
22 15 16 16 17 12 13 13 14 22 22 22 22 15 16 16 17 22 22 22 22 12 13 13 14 15 16 16 17 12 13 13 14 6 7 7 8 22 22 22 22 22 6 7 7 8 22 22 22 22 6 7 7 8 22 22 22 22 22 22 
22 22 22 22 22 15 16 16 17 22 22 1 22 22 22 22 22 22 22 1 22 12 13 13 14 22 22 22 22 15 16 16 17 6 7 7 8 22 22 22 22 22 9 10 10 11 22 22 22 22 9 10 10 11 22 22 22 22 22 22 
22 22 22 22 22 22 22 22 22 1 22 22 22 22 1 22 28 22 22 22 22 15 16 16 17 22 22 22 22 22 22 22 22 9 10 10 11 22 22 22 22 22 12 13 13 14 3 4 4 5 12 13 13 14 22 22 22 22 22 22 
29 29 29 29 29 29 29 29 29 29 18 19 19 19 19 19 19 19 19 19 19 19 19 19 19 19 19 19 19 20 22 22 22 12 13 13 14 22 3 4 4 5 12 13 13 14 6 7 7 8 12 13 13 14 22 3 4 4 5 22 
29 29 29 29 29 29 29 29 29 29 22 22 22 22 22 22 22 22 22 22 22 22 22 22 22 22 22 22 28 23 22 22 22 12 13 13 14 22 6 7 7 8 15 16 16 17 6 7 7 8 15 16 16 17 22 6 7 7 8 22 
29 29 29 29 29 29 29 29 29 31 22 22 27 22 22 22 22 22 22 22 22 22 22 22 22 22 22 22 22 23 22 22 22 15 16 16 17 22 6 7 7 8 22 22 22 22 9 10 10 11 22 22 22 22 22 6 7 7 8 22 
29 29 29 29 29 29 29 29 29 29 22 22 22 22 22 22 22 22 22 22 22 22 22 22 22 22 22 22 22 23 3 4 4 5 22 22 22 22 9 10 10 11 22 22 22 22 12 13 13 14 22 22 22 22 22 9 10 10 11 22 
29 29 29 29 29 29 29 29 29 29 22 22 22 22 22 22 22 22 22 22 22 22 22 22 27 22 22 22 22 23 6 7 7 8 22 22 22 22 12 13 13 14 22 22 22 22 12 13 13 14 22 22 22 22 22 12 13 13 14 22 
29 29 29 29 29 29 29 29 29 29 22 22 22 22 22 22 22 22 22 22 22 22 22 22 22 22 22 22 22 23 6 7 7 8 22 22 22 22 12 13 13 14 22 22 22 22 15 16 16 17 22 22 22 22 22 12 13 13 14 22 
29 29 29 29 29 3 4 4 5 29 24 25 25 25 25 25 25 25 25 25 25 25 25 20 22 22 22 22 22 23 9 10 10 11 22 22 22 22 15 16 16 17 22 22 22 22 22 22 22 22 22 22 22 22 22 15 16 16 17 22 
22 22 22 22 22 6 7 7 8 22 1 22 22 22 27 22 22 22 22 22 22 22 22 21 22 22 22 22 22 23 12 13 13 14 22 22 22 22 22 22 22 3 4 4 5 22 22 22 22 3 4 4 5 22 22 22 22 22 22 22 
22 3 4 4 5 6 7 7 8 3 4 4 5 22 22 22 27 22 1 22 22 1 22 21 22 22 22 22 22 23 12 13 13 14 22 22 22 22 22 22 22 6 7 7 8 3 4 4 5 6 7 7 8 3 4 4 5 22 22 22 
22 6 7 7 8 9 10 10 11 6 7 7 8 22 22 22 22 22 22 22 22 22 22 21 22 22 22 22 22 23 15 16 16 17 22 22 22 22 22 22 22 6 7 7 8 6 7 7 8 6 7 7 8 6 7 7 8 22 22 22 
22 6 7 7 8 12 13 13 14 6 7 7 8 3 4 4 5 22 22 22 1 22 22 21 22 22 22 22 22 23 22 22 22 3 4 4 5 22 22 22 22 9 10 10 11 6 7 7 8 9 10 10 11 6 7 7 8 22 22 22 
22 9 10 10 11 12 13 13 14 9 10 10 11 6 7 7 8 22 22 22 22 22 22 21 22 22 22 22 22 23 22 22 22 6 7 7 8 22 22 22 22 12 13 13 14 9 10 10 11 12 13 13 14 9 10 10 11 22 22 22 
22 12 13 13 14 15 16 16 17 12 13 13 14 6 7 7 8 22 22 22 22 22 22 21 22 22 22 22 22 23 22 1 22 6 7 7 8 22 22 22 22 12 13 13 14 12 13 13 14 12 13 13 14 12 13 13 14 22 22 22 
22 12 13 13 14 22 22 22 22 12 13 13 14 9 10 10 11 22 22 22 22 1 22 21 22 22 22 22 22 23 22 22 22 9 10 10 11 22 22 22 22 15 16 16 17 12 13 13 14 15 16 16 17 12 13 13 14 22 22 22 
22 15 16 16 17 22 22 22 22 15 16 16 17 12 13 13 14 22 22 22 22 22 22 21 22 22 22 22 22 23 22 22 22 12 13 13 14 22 28 22 2 22 22 22 22 15 16 16 17 22 22 22 22 15 16 16 17 22 22 22 
22 22 22 22 22 22 22 22 22 22 22 22 22 12 13 13 14 3 4 4 5 22 28 21 22 22 22 22 22 23 1 22 22 12 13 13 14 22 22 2 28 22 22 22 28 22 22 22 22 22 22 22 22 22 22 22 22 22 22 22 
22 22 22 22 22 22 22 22 22 22 22 22 22 15 16 16 17 6 7 7 8 22 22 21 22 22 22 22 22 23 22 22 22 15 16 16 17 22 2 22 22 18 19 19 19 19 19 19 19 20 29 29 29 29 29 29 29 29 29 29 
22 22 3 4 4 5 22 22 22 22 22 22 22 22 22 22 22 6 7 7 8 22 22 21 22 22 22 22 22 23 3 4 4 5 22 22 22 3 4 4 5 21 22 22 22 22 22 22 22 22 29 29 29 29 29 29 29 29 29 29 
22 22 6 7 7 8 22 22 3 4 4 5 22 22 22 22 22 9 10 10 11 22 22 21 22 22 22 22 22 23 6 7 7 8 22 22 22 6 7 7 8 21 28 22 22 22 22 22 22 22 29 29 29 29 29 29 29 29 29 29 
22 22 6 7 7 8 22 22 6 7 7 8 22 22 22 22 22 12 13 13 14 22 22 21 22 22 22 22 22 23 6 7 7 8 22 22 22 6 7 7 8 21 22 22 22 22 22 22 22 22 30 29 29 29 29 29 29 29 29 29 
22 22 9 10 10 11 22 22 6 7 7 8 22 22 22 22 22 12 13 13 14 22 22 21 22 22 22 22 22 23 9 10 10 11 22 22 22 9 10 10 11 21 22 22 22 22 22 22 22 22 29 29 29 29 29 29 29 29 29 29 
22 22 12 13 13 14 22 22 9 10 10 11 22 22 22 22 22 15 16 16 17 22 22 21 22 22 22 22 22 23 12 13 13 14 22 22 22 12 13 13 14 21 22 22 22 22 22 22 22 22 29 29 29 29 29 29 29 29 29 29 
22 22 12 13 13 14 22 22 12 13 13 14 22 22 22 22 22 22 3 4 4 5 22 21 22 22 22 27 22 23 12 13 13 14 22 22 22 12 13 13 14 21 22 22 22 28 22 18 25 26 29 29 29 29 29 29 29 29 29 29 
22 22 15 16 16 17 22 22 12 13 13 14 3 4 4 5 22 22 6 7 7 8 22 21 22 22 22 22 22 23 15 16 16 17 22 22 22 15 16 16 17 21 22 22 22 22 22 21 22 22 1 29 29 29 29 29 29 29 29 29 
22 22 22 22 22 22 22 22 15 16 16 17 6 7 7 8 22 22 6 7 7 8 22 21 22 22 22 22 22 23 22 22 22 3 4 4 5 22 22 22 22 21 22 22 22 22 22 21 22 22 1 22 3 4 4 5 22 22 22 22 
22 22 3 4 4 5 22 22 22 22 22 22 6 7 7 8 22 22 9 10 10 11 22 21 22 22 22 22 22 23 22 22 22 6 7 7 8 22 22 22 2 21 22 22 22 22 22 21 22 1 22 22 6 7 7 8 22 22 22 22 
22 22 6 7 7 8 22 22 22 22 22 22 9 10 10 11 22 22 12 13 13 14 22 21 22 22 22 22 22 23 22 22 22 6 7 7 8 3 4 4 5 21 22 22 22 22 22 21 22 22 1 22 6 7 7 8 22 22 22 22 
22 22 6 7 7 8 22 3 4 4 5 22 12 13 13 14 22 22 12 13 13 14 22 21 22 22 22 22 22 23 22 22 22 9 10 10 11 6 7 7 8 21 22 22 22 22 22 23 1 22 1 22 9 10 10 11 22 22 22 22 
22 22 9 10 10 11 22 6 7 7 8 22 12 13 13 14 22 22 15 16 16 17 22 21 22 22 22 22 22 23 22 22 22 12 13 13 14 6 7 7 8 21 22 22 22 22 22 23 22 1 22 22 12 13 13 14 22 22 22 22 
22 22 12 13 13 14 22 6 7 7 8 22 15 16 16 17 3 4 4 5 22 22 22 21 22 22 22 22 22 23 22 22 22 12 13 13 14 9 10 10 11 21 22 22 22 22 22 23 3 4 4 5 12 13 13 14 22 22 22 22 
22 22 12 13 13 14 22 9 10 10 11 22 22 22 22 22 6 7 7 8 22 22 22 21 22 22 22 22 22 23 22 22 22 15 16 16 17 12 13 13 14 21 22 22 22 22 22 23 6 7 7 8 15 16 16 17 22 22 22 22 
22 22 15 16 16 17 22 12 13 13 14 22 22 22 22 22 6 7 7 8 22 22 22 21 22 22 22 22 22 23 2 22 22 22 22 22 22 12 13 13 14 21 22 22 22 22 22 23 6 7 7 8 22 22 22 22 22 22 22 22 
22 22 22 22 22 22 22 12 13 13 14 22 22 22 22 22 9 10 10 11 22 22 22 21 22 22 22 22 22 23 22 2 22 22 22 22 22 15 16 16 17 21 22 22 22 22 22 23 9 10 10 11 22 22 22 22 22 22 22 22 
22 22 22 22 22 22 22 15 16 16 17 22 22 22 22 22 12 13 13 14 22 22 28 21 22 22 22 22 22 24 19 19 19 19 19 19 19 19 19 19 19 26 22 22 22 22 22 23 12 13 13 14 22 22 22 22 22 22 22 22 
22 22 22 22 22 22 22 22 22 22 22 3 4 4 5 22 12 13 13 14 22 22 22 21 22 22 22 22 22 22 22 22 22 22 22 22 22 22 22 22 22 22 22 22 22 22 22 23 12 13 13 14 22 22 22 22 22 22 22 22 
22 22 22 22 3 4 4 5 22 22 22 6 7 7 8 22 15 16 16 17 22 22 22 21 22 22 22 22 22 22 22 22 22 22 22 22 22 22 22 22 22 22 22 22 22 22 22 23 15 16 16 17 22 22 22 22 22 22 22 22 
22 22 22 22 6 7 7 8 22 22 22 6 7 7 8 22 22 22 3 4 4 5 22 21 22 22 22 22 22 22 22 22 22 22 22 22 22 22 22 22 22 22 22 22 22 22 22 23 22 22 3 4 4 5 22 22 22 22 22 22 
22 22 22 22 6 7 7 8 22 22 22 9 10 10 11 22 22 22 6 7 7 8 22 21 22 22 22 22 22 22 22 27 22 22 22 22 22 22 22 22 22 22 22 22 22 22 22 23 22 22 6 7 7 8 22 22 22 22 22 22 
22 22 22 22 9 10 10 11 22 22 22 12 13 13 14 22 22 22 6 7 7 8 22 21 22 22 22 22 22 22 22 22 22 22 22 22 22 22 22 22 22 22 22 22 22 22 22 23 22 22 6 7 7 8 22 22 22 22 22 22 
22 22 22 22 12 13 13 14 22 22 22 12 13 13 14 22 22 22 9 10 10 11 22 24 25 25 25 25 25 25 25 25 25 25 25 25 25 25 25 25 25 25 25 25 25 25 25 26 27 22 9 10 10 11 22 22 22 22 22 22 
22 22 22 22 12 13 13 14 22 22 22 15 16 16 17 22 22 22 12 13 13 14 22 22 22 22 3 4 4 5 22 28 22 22 3 4 4 5 22 22 22 22 3 4 4 5 22 22 22 22 12 13 13 14 22 22 22 22 22 22 
22 22 22 22 15 16 16 17 22 22 22 22 22 22 22 22 22 22 12 13 13 14 22 22 22 22 6 7 7 8 22 22 22 22 6 7 7 8 22 22 22 22 6 7 7 8 22 27 22 22 12 13 13 14 3 4 4 5 22 22 
22 22 22 22 22 22 3 4 4 5 22 3 4 4 5 22 22 22 15 16 16 17 3 4 4 5 6 7 7 8 3 4 4 5 6 7 7 8 3 4 4 5 6 7 7 8 3 4 4 5 15 16 16 17 6 7 7 8 22 22 
22 22 22 22 22 22 6 7 7 8 22 6 7 7 8 22 22 22 22 22 22 22 6 7 7 8 9 10 10 11 6 7 7 8 9 10 10 11 6 7 7 8 9 10 10 11 6 7 7 8 22 22 22 22 6 7 7 8 22 22 
22 22 22 22 22 22 6 7 7 8 22 6 7 7 8 22 22 22 22 22 22 22 6 7 7 8 12 13 13 14 6 7 7 8 12 13 13 14 6 7 7 8 12 13 13 14 6 7 7 8 22 22 22 22 9 10 10 11 22 22 
22 22 22 22 22 22 9 10 10 11 22 9 10 10 11 22 22 22 22 22 22 22 9 10 10 11 12 13 13 14 9 10 10 11 12 13 13 14 9 10 10 11 12 13 13 14 9 10 10 11 22 22 22 22 12 13 13 14 22 22 
22 22 22 22 22 22 12 13 13 14 22 12 13 13 14 22 22 22 22 22 22 22 12 13 13 14 15 16 16 17 12 13 13 14 15 16 16 17 12 13 13 14 15 16 16 17 12 13 13 14 22 22 22 22 12 13 13 14 22 22 
22 22 22 22 22 22 12 13 13 14 22 12 13 13 14 22 22 22 22 22 22 22 12 13 13 14 22 22 22 22 12 13 13 14 22 22 22 22 12 13 13 14 22 22 22 22 12 13 13 14 22 22 22 22 15 16 16 17 22 22 
22 22 22 22 22 22 15 16 16 17 22 15 16 16 17 22 22 22 22 22 22 22 15 16 16 17 22 22 22 22 15 16 16 17 22 22 22 22 15 16 16 17 22 22 22 22 15 16 16 17 22 22 22 22 22 22 22 22 22 22 
22 22 22 22 22 22 22 22 22 22 22 22 22 22 22 22 22 22 22 22 22 22 22 22 22 22 22 22 22 22 22 22 22 22 22 22 22 22 22 22 22 22 22 22 22 22 22 22 22 22 22 22 22 22 22 22 22 22 22 22