20 20 20 20 20 20 20 20 20 20 20 20 20 20 20 20 20 20 20 20 20 20 20 20 1 2 2 2 2 2 2 2 2 2 2 3 20 20 20 20 20 20 20 20 20 20 20 20 20 20 20 20 20 20 20 20 20 20 20 20 
20 20 20 20 20 20 20 20 20 20 20 20 20 20 20 20 20 20 20 1 2 2 2 3 4 5 5 5 5 5 5 5 5 5 5 6 1 2 2 2 3 20 20 20 20 20 20 20 20 20 20 20 20 20 20 20 20 20 20 20 
20 20 20 20 20 20 20 20 20 20 20 20 20 20 1 2 2 2 3 4 5 5 5 6 4 5 5 5 5 5 5 5 5 5 5 6 4 5 5 5 6 1 2 2 2 3 20 20 20 20 20 20 20 20 20 20 20 20 20 20 
20 20 20 20 20 20 20 20 20 20 20 20 20 20 4 5 5 5 6 4 5 5 5 6 4 5 5 5 5 5 5 5 5 5 5 6 4 5 5 5 6 4 5 5 5 6 20 20 20 20 20 20 20 20 20 20 20 20 20 20 
20 20 20 20 20 20 20 20 20 20 20 20 20 20 4 5 5 5 6 4 5 5 5 6 7 8 8 8 8 8 8 8 8 8 8 9 4 5 5 5 6 4 5 5 5 6 20 20 20 20 20 20 20 20 20 20 20 20 20 20 
20 20 20 20 20 20 20 20 20 20 20 20 20 20 4 5 5 5 6 7 8 8 8 9 10 11 11 11 11 11 11 11 11 11 11 12 7 8 8 8 9 4 5 5 5 6 20 20 20 20 20 20 20 20 20 20 20 20 20 20 
20 20 20 20 20 20 20 20 20 20 20 20 20 20 7 8 8 8 9 10 11 11 11 12 10 11 11 11 11 11 11 11 11 11 11 12 10 11 11 11 12 7 8 8 8 9 20 20 20 20 20 20 20 20 20 20 20 20 20 20 
20 20 20 20 20 20 20 20 20 20 20 20 20 20 10 11 11 11 12 10 11 11 11 12 10 11 11 11 11 11 11 11 11 11 11 12 10 11 11 11 12 10 11 11 11 12 20 20 20 20 20 20 20 20 20 20 20 20 20 20 
20 20 20 20 20 20 20 20 20 20 20 20 20 20 10 11 11 11 12 10 11 11 11 12 13 14 14 14 14 14 14 14 14 14 14 15 10 11 11 11 12 10 11 11 11 12 20 20 20 20 20 20 20 20 20 20 20 20 20 20 
20 20 20 20 20 20 20 20 20 1 2 2 2 3 10 11 11 11 12 13 14 14 14 15 25 25 25 25 25 25 25 25 25 25 25 25 13 14 14 14 15 10 11 11 11 12 1 2 2 2 3 20 20 20 20 20 20 20 20 20 
20 20 20 20 20 20 20 20 20 4 5 5 5 6 13 14 14 14 15 25 25 25 25 25 25 25 25 25 25 25 25 25 25 25 25 25 25 25 25 25 25 13 14 14 14 15 4 5 5 5 6 20 20 20 20 20 20 20 20 20 
20 20 20 20 20 20 20 20 20 4 5 5 5 6 25 25 25 25 16 17 17 17 17 17 17 17 17 17 17 17 17 17 17 17 17 17 17 17 17 17 17 18 25 25 25 25 4 5 5 5 6 20 20 20 20 20 20 20 20 20 
20 20 20 20 20 20 20 20 20 4 5 5 5 6 25 25 25 25 19 20 20 20 20 20 20 20 20 20 20 20 20 20 20 20 20 20 20 20 20 20 20 21 25 25 25 25 4 5 5 5 6 20 20 20 20 20 20 20 20 20 
20 20 20 20 20 20 20 20 20 7 8 8 8 9 25 25 25 25 19 20 20 20 20 20 20 20 20 20 20 20 20 20 20 20 20 20 20 20 20 20 20 21 25 25 25 25 7 8 8 8 9 20 20 20 20 20 20 20 20 20 
20 20 20 20 20 20 20 20 20 10 11 11 11 12 25 16 17 17 24 20 20 20 20 20 20 20 20 20 20 20 20 20 20 20 20 20 20 20 20 20 20 22 17 17 18 25 10 11 11 11 12 20 20 20 20 20 20 20 20 20 
20 20 20 20 20 20 20 20 20 10 11 11 11 12 16 24 20 20 20 20 20 20 20 20 20 20 20 20 20 20 20 20 20 20 20 20 20 20 20 20 20 20 20 20 22 18 10 11 11 11 12 20 20 20 20 20 20 20 20 20 
20 20 20 20 20 20 20 20 20 10 11 11 11 12 19 20 20 20 20 20 20 20 20 20 20 20 20 20 20 20 20 20 20 20 20 20 20 20 20 20 20 20 20 20 20 21 10 11 11 11 12 1 2 2 2 3 20 20 20 20 
20 20 20 20 1 2 2 2 3 13 14 14 14 15 19 20 20 20 20 20 20 20 20 20 20 20 20 20 20 20 20 20 20 20 20 20 20 20 20 20 20 20 20 20 20 21 13 14 14 14 15 4 5 5 5 6 20 20 20 20 
20 20 20 20 4 5 5 5 6 25 25 16 17 17 24 20 20 20 20 20 20 20 20 20 20 20 20 20 20 20 20 20 20 20 20 20 20 20 20 20 20 20 20 20 20 22 17 17 18 25 25 4 5 5 5 6 20 20 20 20 
20 20 20 20 4 5 5 5 6 25 25 19 20 20 20 20 20 20 20 20 20 20 20 20 20 20 20 20 20 20 20 20 20 20 20 20 20 20 20 20 20 20 20 20 20 20 20 20 21 25 25 4 5 5 5 6 20 20 20 20 
20 20 20 20 4 5 5 5 6 25 25 19 20 20 20 20 20 20 20 20 16 17 17 17 17 17 17 17 17 17 17 17 17 17 17 17 17 17 17 18 20 20 20 20 20 20 20 20 21 25 25 7 8 8 8 9 20 20 20 20 
20 20 20 20 7 8 8 8 9 25 25 19 20 20 20 20 20 20 20 20 19 20 20 20 20 20 20 20 20 20 20 20 20 20 20 20 20 20 20 21 20 20 20 20 20 20 20 20 21 25 25 10 11 11 11 12 20 20 20 20 
20 20 20 20 10 11 11 11 12 25 25 19 20 20 20 20 20 20 20 20 19 20 20 20 20 20 20 20 20 20 20 20 20 20 20 20 20 20 20 21 20 20 20 20 20 20 20 20 21 25 25 10 11 11 11 12 20 20 20 20 
20 20 20 20 10 11 11 11 12 25 25 19 20 20 20 20 20 20 20 20 19 20 20 20 20 20 20 20 20 20 20 20 20 20 20 20 20 20 20 21 20 20 20 20 20 20 20 20 21 25 25 10 11 11 11 12 20 20 20 20 
20 20 20 20 10 11 11 11 12 25 25 19 20 20 20 20 20 20 20 20 19 20 20 20 20 20 20 20 20 20 20 20 20 20 20 20 20 20 20 21 20 20 20 20 20 20 20 20 21 25 25 13 14 14 14 15 20 20 20 20 
20 20 20 20 13 14 14 14 15 25 25 19 20 20 20 20 20 20 20 20 19 20 20 20 20 20 20 20 20 20 20 20 20 20 20 20 20 20 20 21 20 20 20 20 20 20 20 20 21 25 25 1 2 2 2 3 20 20 20 20 
20 20 20 20 1 2 2 2 3 25 25 19 20 20 20 20 20 20 20 20 19 20 20 20 20 20 20 20 20 20 20 20 20 20 20 20 20 20 20 21 20 20 20 20 20 20 20 20 21 25 25 4 5 5 5 6 20 20 20 20 
20 20 20 20 4 5 5 5 6 25 25 19 20 20 20 20 20 20 20 20 19 20 20 20 20 20 20 20 20 20 20 20 20 20 20 20 20 20 20 21 20 20 20 20 20 20 20 20 21 25 25 4 5 5 5 6 20 20 20 20 
20 20 20 20 4 5 5 5 6 25 25 19 20 20 20 20 20 20 20 20 19 20 20 20 20 20 20 20 20 20 20 20 20 20 20 20 20 20 20 21 20 20 20 20 20 20 20 20 21 25 25 4 5 5 5 6 20 20 20 20 
20 20 20 20 4 5 5 5 6 25 25 19 20 20 20 28 29 20 20 20 19 20 20 20 20 20 20 20 20 20 20 20 20 20 20 20 20 20 20 21 20 20 20 32 33 20 20 20 21 25 25 7 8 8 8 9 20 20 20 20 
20 20 20 20 7 8 8 8 9 25 25 19 20 20 20 30 31 20 20 20 19 20 20 20 20 20 20 20 20 20 20 20 20 20 20 20 20 20 20 21 20 20 20 34 35 20 20 20 21 25 25 10 11 11 11 12 20 20 20 20 
20 20 20 20 10 11 11 11 12 25 25 19 20 20 20 20 20 20 20 20 19 20 20 20 20 20 20 20 20 20 20 20 20 20 20 20 20 20 20 21 20 20 20 20 20 20 20 20 21 25 25 10 11 11 11 12 20 20 20 20 
20 20 20 20 10 11 11 11 12 25 25 19 20 20 20 20 20 20 20 20 19 20 20 20 20 20 20 20 20 20 20 20 20 20 20 20 20 20 20 21 20 20 20 20 20 20 20 20 21 25 25 10 11 11 11 12 20 20 20 20 
20 20 20 20 10 11 11 11 12 25 25 19 20 20 20 20 20 20 20 20 19 20 20 20 20 20 20 20 20 20 20 20 20 20 20 20 20 20 20 21 20 20 20 20 20 20 20 20 21 25 25 13 14 14 14 15 20 20 20 20 
20 20 20 20 13 14 14 14 15 25 25 19 20 20 20 20 20 20 20 20 19 20 20 20 20 20 20 20 20 20 20 20 20 20 20 20 20 20 20 21 20 20 20 20 20 20 20 20 21 25 25 1 2 2 2 3 20 20 20 20 
20 20 20 20 1 2 2 2 3 25 25 19 20 20 20 20 20 20 20 20 19 20 20 20 20 20 20 20 20 20 20 20 20 20 20 20 20 20 20 21 20 20 20 20 20 20 20 20 21 25 25 4 5 5 5 6 20 20 20 20 
20 20 20 20 4 5 5 5 6 25 25 19 20 20 20 20 20 20 20 20 19 20 20 20 20 20 20 20 20 20 20 20 20 20 20 20 20 20 20 21 20 20 20 20 20 20 20 20 21 25 25 4 5 5 5 6 20 20 20 20 
20 20 20 20 4 5 5 5 6 25 25 19 20 20 20 20 20 20 20 20 19 20 20 20 20 20 20 20 20 20 20 20 20 20 20 20 20 20 20 21 20 20 20 20 20 20 20 20 21 25 25 4 5 5 5 6 20 20 20 20 
20 20 20 20 4 5 5 5 6 25 25 19 20 20 20 20 20 20 20 20 19 20 20 20 20 20 20 20 20 20 20 20 20 20 20 20 20 20 20 21 20 20 20 20 20 20 20 20 21 25 25 7 8 8 8 9 20 20 20 20 
20 20 20 20 7 8 8 8 9 25 25 19 20 20 20 20 20 20 20 20 22 23 23 23 23 23 23 23 23 23 23 23 23 23 23 23 23 23 23 24 20 20 20 20 20 20 20 20 21 25 25 10 11 11 11 12 20 20 20 20 
20 20 20 20 10 11 11 11 12 25 25 19 20 20 20 20 20 20 20 20 20 20 20 20 20 20 20 20 20 20 20 20 20 20 20 20 20 20 20 20 20 20 20 20 20 20 20 20 21 25 25 10 11 11 11 12 20 20 20 20 
20 20 20 20 10 11 11 11 12 25 25 22 23 23 18 20 20 20 20 20 20 20 20 20 20 20 20 20 20 20 20 20 20 20 20 20 20 20 20 20 20 20 20 20 20 16 23 23 24 25 25 10 11 11 11 12 20 20 20 20 
20 20 20 20 10 11 11 11 12 1 2 2 2 3 19 20 20 20 20 20 20 20 20 20 20 20 20 20 20 20 20 20 20 20 20 20 20 20 20 20 20 20 20 20 20 21 1 2 2 2 3 13 14 14 14 15 20 20 20 20 
20 20 20 20 13 14 14 14 15 4 5 5 5 6 19 20 20 20 20 20 20 20 20 20 20 20 20 20 20 20 20 20 20 20 20 20 20 20 20 20 20 20 20 20 20 21 4 5 5 5 6 20 20 20 20 20 20 20 20 20 
20 20 20 20 20 20 20 20 20 4 5 5 5 6 22 18 20 20 20 20 20 20 20 20 20 20 20 20 20 20 20 20 20 20 20 20 20 20 20 20 20 20 20 20 16 24 4 5 5 5 6 20 20 20 20 20 20 20 20 20 
20 20 20 20 20 20 20 20 20 4 5 5 5 6 25 22 23 23 18 20 20 20 20 20 20 20 20 20 20 20 20 20 20 20 20 20 20 20 20 20 20 16 23 23 24 25 4 5 5 5 6 20 20 20 20 20 20 20 20 20 
20 20 20 20 20 20 20 20 20 7 8 8 8 9 25 25 25 25 19 20 20 20 20 20 20 20 20 20 20 20 20 20 20 20 20 20 20 20 20 20 20 21 25 25 25 25 7 8 8 8 9 20 20 20 20 20 20 20 20 20 
20 20 20 20 20 20 20 20 20 10 11 11 11 12 25 25 25 25 19 20 20 20 20 20 20 20 20 20 20 20 20 20 20 20 20 20 20 20 20 20 20 21 25 25 25 25 10 11 11 11 12 20 20 20 20 20 20 20 20 20 
20 20 20 20 20 20 20 20 20 10 11 11 11 12 25 25 25 25 22 23 23 23 23 23 23 23 23 23 23 23 23 23 23 23 23 23 23 23 23 23 23 24 25 25 25 25 10 11 11 11 12 20 20 20 20 20 20 20 20 20 
20 20 20 20 20 20 20 20 20 10 11 11 11 12 1 2 2 2 3 25 25 25 25 25 25 25 25 25 25 25 25 25 25 25 25 25 25 25 25 25 25 1 2 2 2 3 10 11 11 11 12 20 20 20 20 20 20 20 20 20 
20 20 20 20 20 20 20 20 20 13 14 14 14 15 4 5 5 5 6 1 2 2 2 3 25 25 25 25 25 25 25 25 25 25 25 25 1 2 2 2 3 4 5 5 5 6 13 14 14 14 15 20 20 20 20 20 20 20 20 20 
20 20 20 20 20 20 20 20 20 20 20 20 20 20 4 5 5 5 6 4 5 5 5 6 1 2 2 2 2 2 2 2 2 2 2 3 4 5 5 5 6 4 5 5 5 6 20 20 20 20 20 20 20 20 20 20 20 20 20 20 
20 20 20 20 20 20 20 20 20 20 20 20 20 20 4 5 5 5 6 4 5 5 5 6 4 5 5 5 5 5 5 5 5 5 5 6 4 5 5 5 6 4 5 5 5 6 20 20 20 20 20 20 20 20 20 20 20 20 20 20 
20 20 20 20 20 20 20 20 20 20 20 20 20 20 7 8 8 8 9 4 5 5 5 6 4 5 5 5 5 5 5 5 5 5 5 6 4 5 5 5 6 7 8 8 8 9 20 20 20 20 20 20 20 20 20 20 20 20 20 20 
20 20 20 20 20 20 20 20 20 20 20 20 20 20 10 11 11 11 12 7 8 8 8 9 4 5 5 5 5 5 5 5 5 5 5 6 7 8 8 8 9 10 11 11 11 12 20 20 20 20 20 20 20 20 20 20 20 20 20 20 
20 20 20 20 20 20 20 20 20 20 20 20 20 20 10 11 11 11 12 10 11 11 11 12 7 8 8 8 8 8 8 8 8 8 8 9 10 11 11 11 12 10 11 11 11 12 20 20 20 20 20 20 20 20 20 20 20 20 20 20 
20 20 20 20 20 20 20 20 20 20 20 20 20 20 10 11 11 11 12 10 11 11 11 12 10 11 11 11 11 11 11 11 11 11 11 12 10 11 11 11 12 10 11 11 11 12 20 20 20 20 20 20 20 20 20 20 20 20 20 20 
20 20 20 20 20 20 20 20 20 20 20 20 20 20 13 14 14 14 15 10 11 11 11 12 10 11 11 11 11 11 11 11 11 11 11 12 10 11 11 11 12 13 14 14 14 15 20 20 20 20 20 20 20 20 20 20 20 20 20 20 
20 20 20 20 20 20 20 20 20 20 20 20 20 20 20 20 20 20 20 13 14 14 14 15 10 11 11 11 11 11 11 11 11 11 11 12 13 14 14 14 15 20 20 20 20 20 20 20 20 20 20 20 20 20 20 20 20 20 20 20 
20 20 20 20 20 20 20 20 20 20 20 20 20 20 20 20 20 20 20 20 20 20 20 20 13 14 14 14 14 14 14 14 14 14 14 15 20 20 20 20 20 20 20 20 20 20 20 20 20 20 20 20 20 20 20 20 20 20 20 20